19 25
+-------+-------+-+
|       |       | |
| +---+ +---+ + | |
|     | |     | | |
+---+ | + +-+ | | |
|     |   |   | | |
| +-+ +-+-+ +-+ + |
| | | | | | |     |
| | +-+ | +-+ +---+
| | |   |     |   |
| + | + +---+-+ + |
|   | |     |   | |
| +-+ | +---+---+ |
|     | |         |
+-+---+ | +---+ + |
| |     | |     | |
| | +---+ | +---+-+
| |       |       |
| +---+ +-+-+ +-+ |
|     |   | | | | |
| +-+ | + | +-+ | |
|   | | | |     | |
+-+ | + | + +---+ |
|   |   |   |     |
+---+---+---+-----+
