41 17
+---+---+---+---+-------+---+---+---+---+
|   |   |   |   |       |   |   |   |   |
| +-+ +-+ + | +-+ +-+ + | +-+ +-+ + +-+ |
|   |   | | |     |   | |     |   |   | |
| +-+-+ | | +-+ +-+-+ | +-+ +-+ +-+-+ +-+
| |   | | |   |     | |   | |   | | |   |
| | +-+ +-+ +-+ +-+ | | +-+ | +-+ | +-+ |
| |     |   |   | | | |   | |   | |   | |
| +-+ +-+-+ | +-+ | | +-+ | +-+ | +-+ | |
| |       | |   | | |   | |   | |   | | |
| | +---+ | +-+ +-+ | +-+ +-+ | +-+ | | |
| | |     |   |     |   |   | |   | | | |
| +-+ + +-+-+ | +-+-+ + +-+ + | +-+ | | |
|     |       |   |   |   |   |   | | | |
| +-+ +-+ +-+ + +-+ +-+ + +-+ + +-+ | + |
|   |   |   |   |   |   |   |   |   |   |
+---+---+---+---+---+---+---+---+---+---+